1111111111111
10000000000E1
100C000000001
1000000000001
1000010C00P01
100000C000001
1000000000001
1111111111111
