11111111111111111
10100001000010011
100C0011000100001
100100001C0C00C01
1C000000001100011
100000100000000C1
10P00000100000111
11110100100C00001
1100001C000000001
1000000000C000001
100000C0010000001
1101000C000001001
10000C00000000101
10C0101000C010001
1010C100000000EC1
11111111111111111
