11111
11P01
10001
10001
100C1
10001
1C001
1C001
100C1
100C1
1E001
11111
