11111111111111111111111
11000000000100000000001
10000000001010001000001
11010000000000010E00111
11000000000100000000001
10000000000000000P00001
10000001001000001000001
10000000010100000000001
10000000000010000110011
10100011000000000000001
10000000000000001C00C01
10001001000000000000C01
10100000000000000000101
10000001010000000000001
10000000000000100000001
10000001001000000010001
10000001000000001000001
11111111111111111111111
