111111111111111111111
10P010000000C00C01C01
101000000000010000001
100C010001000010C0001
100000100000001000001
100000000000000000001
1C0000000001C0C100001
1C11000001010100000C1
10000C000000000E00001
111111111111111111111
