1111111111111
10C0CC0100PC1
1001000000011
10C0000000001
10001000001E1
101C00C000001
1000000000001
1111111111111