111111111111
100C0E0000C1
10000C000C01
1000f0000C01
10CC00C00001
100000100001
1010C000CCP1
111111111111
