111111111111111111111
100010C0000010010C001
1CC0101C00C1010001001
1001C010011001C0C00C1
100001C001C00100110C1
10000C0C0010001C10CP1
111010011100110000001
1C000001C10C00C000001
10000101111C001000001
10C01000000001100C001
10100010C01C000000001
1000C100C0C10C0000001
10100000000C0C00C1001
100100C0000C0000C0001
11010C0C01C1000000101
100110100001000C00101
100C010100C000C0C0001
110E100000100CCC00001
111111111111111111111
